// size in X, size in Y and layer count
11, 10, 2,

12,		24,		24,		24,		24,		24,		24,		24,		24,		24,		13,
15,		4,		4,		4, 		4,		4,		4,		4,		4,		4,		25,
15,		4,		4,		4, 		4,		4,		4,		4,		4,		4,		25,
15,		4,		4,		4, 		4,		4,		4,		4,		4,		4,		25,
15,		4,		4,		4, 		4,		4,		4,		4,		4,		4,		25,
15,		4,		4,		4, 		4,		4,		4,		4,		4,		4,		25,
15,		4,		4,		4, 		4,		4,		4,		4,		4,		4,		25,
15,		4,		4,		4, 		4,		4,		4,		4,		4,		4,		25,
15,		4,		4,		4, 		4,		4,		4,		4,		4,		4,		25,
22,		14,		14,		14,		14,		14,		14,		14,		14,		14,		23,


1,		1,		1,		1,		1,		1,		1,		1,		1,		1,		1,
1,		30,		44,		31,		30,		44,		31,		30,		44,		31,		1,
1,		40,		133,		41,		133,		40,		133,		41,		40,		133,		1,
1,		1,		1,		1,		1,		1,		1,		1,		1,		1,		1,
1,		1,		1,		1,		1,		1,		1,		1,		1,		1,		1,
1,		1,		1,		1,		1,		1,		1,		1,		1,		1,		1,
1,		30,		44,		31,		30,		44,		31,		30,		44,		31,		1,
1,		40,		133,		41,		133,		40,		133,		41,		40,		133,		1,
1,		1,		1,		1,		1,		1,		1,		1,		1,		1,		1,
